111111111111111
100000011C10001
10P00000010E001
10000C010000001
111111111111111
