111111111111111
100000000000001
10P000000T00001
100000000000001
111111111111111
