11111111111111111
100C01000000P0001
10010100C00000001
1001C0000000000C1
10000000000001111
10010000100000001
10000000100000001
10000000100000001
10011100100000001
1001C100111100C01
10000000100000001
10000000101001001
10000000000000001
1000C0000000C00E1
11111111111111111
