1111111111
100C000001
10P10E0001
1001C00001
1111111111
