111111111111111
100000010C00001
10P00001000E001
10000C010000001
111111111111111
