111111111111111
100000000000000
10P000000000001
100000000000001
111111111111111
